! Kilobolt Studios
! http://kilobolt.com
! Game Development Tutorial - Unit 3
! Q-Bot Level 1
! # = Tile Legend 
! 5 = TileDirt
! 8 = GrassTop
! 2 = GrassBot
! 4 = GrassLeft
! 6 = GrassRight 
11112212121212122222112121221221111122121212121222221121212212211111221212121212222211212122122111112212121212122222112121221221111122121212121222221121212212211111221212121212222211212122122122222221121112121121212121211221
12121212112221212112121212121211221222222211211121211212121212112121212112221212112121212121211221222222211211121211212121212112121212112221212112121212121211221222222211211121211212121212112121212112221212112121212121211221
11111111111111111111111111111111111111111111111111111111111111111111111111111111111111111111111111111111111111111111111111111111111111111111111111111111111111111111111111111111111111111111111111111111111111111111111111111111
22222222222222222222222222222222222222222222222222222222222222222222222222222222222222222222222222222222222222222222222222222222222222222222222222222222222222222222222222222222222222222222222222222222222222222222222222222222
11112212121212122222112121221221111122121212121222221121212212211111221212121212222211212122122111112212121212122222112121221221111122121212121222221121212212211111221212121212222211212122122111112212121212122222112121221221
11112212121212122222112121221221111122121212121222221121212212211111221212121212222211212122122111112212121212122222112121221221111122121212121222221121212212211111221212121212222211212122122122222221121112121121212121211221
12121212112221212112121212121211221222222211211121211212121212112121212112221212112121212121211221222222211211121211212121212112121212112221212112121212121211221222222211211121211212121212112121212112221212112121212121211221
11111111111111111111111111111111111111111111111111111111111111111111111111111111111111111111111111111111111111111111111111111111111111111111111111111111111111111111111111111111111111111111111111111111111111111111111111111111
22222222222222222222222222222222222222222222222222222222222222222222222222222222222222222222222222222222222222222222222222222222222222222222222222222222222222222222222222222222222222222222222222222222222222222222222222222222
11112212121212122222112121221221111122121212121222221121212212211111221212121212222211212122122111112212121212122222112121221221111122121212121222221121212212211111221212121212222211212122122111112212121212122222112121221221
11112212121212122222112121221221111122121212121222221121212212211111221212121212222211212122122111112212121212122222112121221221111122121212121222221121212212211111221212121212222211212122122122222221121112121121212121211221
12121212112221212112121212121211221222222211211121211212121212112121212112221212112121212121211221222222211211121211212121212112121212112221212112121212121211221222222211211121211212121212112121212112221212112121212121211221
11111111111111111111111111111111111111111111111111111111111111111111111111111111111111111111111111111111111111111111111111111111111111111111111111111111111111111111111111111111111111111111111111111111111111111111111111111111
22222222222222222222222222222222222222222222222222222222222222222222222222222222222222222222222222222222222222222222222222222222222222222222222222222222222222222222222222222222222222222222222222222222222222222222222222222222
11112212121212122222112121221221111122121212121222221121212212211111221212121212222211212122122111112212121212122222112121221221111122121212121222221121212212211111221212121212222211212122122111112212121212122222112121221221
11112212121212122222112121221221111122121212121222221121212212211111221212121212222211212122122111112212121212122222112121221221111122121212121222221121212212211111221212121212222211212122122122222221121112121121212121211221
12121212112221212112121212121211221222222211211121211212121212112121212112221212112121212121211221222222211211121211212121212112121212112221212112121212121211221222222211211121211212121212112121212112221212112121212121211221
11111111111111111111111111111111111111111111111111111111111111111111111111111111111111111111111111111111111111111111111111111111111111111111111111111111111111111111111111111111111111111111111111111111111111111111111111111111
22222222222222222222222222222222222222222222222222222222222222222222222222222222222222222222222222222222222222222222222222222222222222222222222222222222222222222222222222222222222222222222222222222222222222222222222222222222
11112212121212122222112121221221111122121212121222221121212212211111221212121212222211212122122111112212121212122222112121221221111122121212121222221121212212211111221212121212222211212122122111112212121212122222112121221221
11112212121212122222112121221221111122121212121222221121212212211111221212121212222211212122122111112212121212122222112121221221111122121212121222221121212212211111221212121212222211212122122122222221121112121121212121211221
12121212112221212112121212121211221222222211211121211212121212112121212112221212112121212121211221222222211211121211212121212112121212112221212112121212121211221222222211211121211212121212112121212112221212112121212121211221
11111111111111111111111111111111111111111111111111111111111111111111111111111111111111111111111111111111111111111111111111111111111111111111111111111111111111111111111111111111111111111111111111111111111111111111111111111111
22222222222222222222222222222222222222222222222222222222222222222222222222222222222222222222222222222222222222222222222222222222222222222222222222222222222222222222222222222222222222222222222222222222222222222222222222222222
11112212121212122222112121221221111122121212121222221121212212211111221212121212222211212122122111112212121212122222112121221221111122121212121222221121212212211111221212121212222211212122122111112212121212122222112121221221
11112212121212122222112121221221111122121212121222221121212212211111221212121212222211212122122111112212121212122222112121221221111122121212121222221121212212211111221212121212222211212122122122222221121112121121212121211221
12121212112221212112121212121211221222222211211121211212121212112121212112221212112121212121211221222222211211121211212121212112121212112221212112121212121211221222222211211121211212121212112121212112221212112121212121211221
11111111111111111111111111111111111111111111111111111111111111111111111111111111111111111111111111111111111111111111111111111111111111111111111111111111111111111111111111111111111111111111111111111111111111111111111111111111
22222222222222222222222222222222222222222222222222222222222222222222222222222222222222222222222222222222222222222222222222222222222222222222222222222222222222222222222222222222222222222222222222222222222222222222222222222222
11112212121212122222112121221221111122121212121222221121212212211111221212121212222211212122122111112212121212122222112121221221111122121212121222221121212212211111221212121212222211212122122111112212121212122222112121221221
11112212121212122222112121221221111122121212121222221121212212211111221212121212222211212122122111112212121212122222112121221221111122121212121222221121212212211111221212121212222211212122122122222221121112121121212121211221
12121212112221212112121212121211221222222211211121211212121212112121212112221212112121212121211221222222211211121211212121212112121212112221212112121212121211221222222211211121211212121212112121212112221212112121212121211221
11111111111111111111111111111111111111111111111111111111111111111111111111111111111111111111111111111111111111111111111111111111111111111111111111111111111111111111111111111111111111111111111111111111111111111111111111111111
22222222222222222222222222222222222222222222222222222222222222222222222222222222222222222222222222222222222222222222222222222222222222222222222222222222222222222222222222222222222222222222222222222222222222222222222222222222
11112212121212122222112121221221111122121212121222221121212212211111221212121212222211212122122111112212121212122222112121221221111122121212121222221121212212211111221212121212222211212122122111112212121212122222112121221221
11112212121212122222112121221221111122121212121222221121212212211111221212121212222211212122122111112212121212122222112121221221111122121212121222221121212212211111221212121212222211212122122122222221121112121121212121211221
12121212112221212112121212121211221222222211211121211212121212112121212112221212112121212121211221222222211211121211212121212112121212112221212112121212121211221222222211211121211212121212112121212112221212112121212121211221
11111111111111111111111111111111111111111111111111111111111111111111111111111111111111111111111111111111111111111111111111111111111111111111111111111111111111111111111111111111111111111111111111111111111111111111111111111111
22222222222222222222222222222222222222222222222222222222222222222222222222222222222222222222222222222222222222222222222222222222222222222222222222222222222222222222222222222222222222222222222222222222222222222222222222222222
11112212121212122222112121221221111122121212121222221121212212211111221212121212222211212122122111112212121212122222112121221221111122121212121222221121212212211111221212121212222211212122122111112212121212122222112121221221
11112212121212122222112121221221111122121212121222221121212212211111221212121212222211212122122111112212121212122222112121221221111122121212121222221121212212211111221212121212222211212122122122222221121112121121212121211221
12121212112221212112121212121211221222222211211121211212121212112121212112221212112121212121211221222222211211121211212121212112121212112221212112121212121211221222222211211121211212121212112121212112221212112121212121211221
11111111111111111111111111111111111111111111111111111111111111111111111111111111111111111111111111111111111111111111111111111111111111111111111111111111111111111111111111111111111111111111111111111111111111111111111111111111
22222222222222222222222222222222222222222222222222222222222222222222222222222222222222222222222222222222222222222222222222222222222222222222222222222222222222222222222222222222222222222222222222222222222222222222222222222222
11112212121212122222112121221221111122121212121222221121212212211111221212121212222211212122122111112212121212122222112121221221111122121212121222221121212212211111221212121212222211212122122111112212121212122222112121221221
11112212121212122222112121221221111122121212121222221121212212211111221212121212222211212122122111112212121212122222112121221221111122121212121222221121212212211111221212121212222211212122122122222221121112121121212121211221
12121212112221212112121212121211221222222211211121211212121212112121212112221212112121212121211221222222211211121211212121212112121212112221212112121212121211221222222211211121211212121212112121212112221212112121212121211221
11111111111111111111111111111111111111111111111111111111111111111111111111111111111111111111111111111111111111111111111111111111111111111111111111111111111111111111111111111111111111111111111111111111111111111111111111111111
22222222222222222222222222222222222222222222222222222222222222222222222222222222222222222222222222222222222222222222222222222222222222222222222222222222222222222222222222222222222222222222222222222222222222222222222222222222
11112212121212122222112121221221111122121212121222221121212212211111221212121212222211212122122111112212121212122222112121221221111122121212121222221121212212211111221212121212222211212122122111112212121212122222112121221221
11112212121212122222112121221221111122121212121222221121212212211111221212121212222211212122122111112212121212122222112121221221111122121212121222221121212212211111221212121212222211212122122122222221121112121121212121211221
12121212112221212112121212121211221222222211211121211212121212112121212112221212112121212121211221222222211211121211212121212112121212112221212112121212121211221222222211211121211212121212112121212112221212112121212121211221
11111111111111111111111111111111111111111111111111111111111111111111111111111111111111111111111111111111111111111111111111111111111111111111111111111111111111111111111111111111111111111111111111111111111111111111111111111111
22222222222222222222222222222222222222222222222222222222222222222222222222222222222222222222222222222222222222222222222222222222222222222222222222222222222222222222222222222222222222222222222222222222222222222222222222222222
11112212121212122222112121221221111122121212121222221121212212211111221212121212222211212122122111112212121212122222112121221221111122121212121222221121212212211111221212121212222211212122122111112212121212122222112121221221
11112212121212122222112121221221111122121212121222221121212212211111221212121212222211212122122111112212121212122222112121221221111122121212121222221121212212211111221212121212222211212122122122222221121112121121212121211221
12121212112221212112121212121211221222222211211121211212121212112121212112221212112121212121211221222222211211121211212121212112121212112221212112121212121211221222222211211121211212121212112121212112221212112121212121211221
11111111111111111111111111111111111111111111111111111111111111111111111111111111111111111111111111111111111111111111111111111111111111111111111111111111111111111111111111111111111111111111111111111111111111111111111111111111
22222222222222222222222222222222222222222222222222222222222222222222222222222222222222222222222222222222222222222222222222222222222222222222222222222222222222222222222222222222222222222222222222222222222222222222222222222222
11112212121212122222112121221221111122121212121222221121212212211111221212121212222211212122122111112212121212122222112121221221111122121212121222221121212212211111221212121212222211212122122111112212121212122222112121221221
11112212121212122222112121221221111122121212121222221121212212211111221212121212222211212122122111112212121212122222112121221221111122121212121222221121212212211111221212121212222211212122122122222221121112121121212121211221
12121212112221212112121212121211221222222211211121211212121212112121212112221212112121212121211221222222211211121211212121212112121212112221212112121212121211221222222211211121211212121212112121212112221212112121212121211221
11111111111111111111111111111111111111111111111111111111111111111111111111111111111111111111111111111111111111111111111111111111111111111111111111111111111111111111111111111111111111111111111111111111111111111111111111111111
22222222222222222222222222222222222222222222222222222222222222222222222222222222222222222222222222222222222222222222222222222222222222222222222222222222222222222222222222222222222222222222222222222222222222222222222222222222
11112212121212122222112121221221111122121212121222221121212212211111221212121212222211212122122111112212121212122222112121221221111122121212121222221121212212211111221212121212222211212122122111112212121212122222112121221221
11112212121212122222112121221221111122121212121222221121212212211111221212121212222211212122122111112212121212122222112121221221111122121212121222221121212212211111221212121212222211212122122122222221121112121121212121211221
12121212112221212112121212121211221222222211211121211212121212112121212112221212112121212121211221222222211211121211212121212112121212112221212112121212121211221222222211211121211212121212112121212112221212112121212121211221
11111111111111111111111111111111111111111111111111111111111111111111111111111111111111111111111111111111111111111111111111111111111111111111111111111111111111111111111111111111111111111111111111111111111111111111111111111111
22222222222222222222222222222222222222222222222222222222222222222222222222222222222222222222222222222222222222222222222222222222222222222222222222222222222222222222222222222222222222222222222222222222222222222222222222222222
11112212121212122222112121221221111122121212121222221121212212211111221212121212222211212122122111112212121212122222112121221221111122121212121222221121212212211111221212121212222211212122122111112212121212122222112121221221
11112212121212122222112121221221111122121212121222221121212212211111221212121212222211212122122111112212121212122222112121221221111122121212121222221121212212211111221212121212222211212122122122222221121112121121212121211221
12121212112221212112121212121211221222222211211121211212121212112121212112221212112121212121211221222222211211121211212121212112121212112221212112121212121211221222222211211121211212121212112121212112221212112121212121211221
11111111111111111111111111111111111111111111111111111111111111111111111111111111111111111111111111111111111111111111111111111111111111111111111111111111111111111111111111111111111111111111111111111111111111111111111111111111
22222222222222222222222222222222222222222222222222222222222222222222222222222222222222222222222222222222222222222222222222222222222222222222222222222222222222222222222222222222222222222222222222222222222222222222222222222222
11112212121212122222112121221221111122121212121222221121212212211111221212121212222211212122122111112212121212122222112121221221111122121212121222221121212212211111221212121212222211212122122111112212121212122222112121221221
11112212121212122222112121221221111122121212121222221121212212211111221212121212222211212122122111112212121212122222112121221221111122121212121222221121212212211111221212121212222211212122122122222221121112121121212121211221
12121212112221212112121212121211221222222211211121211212121212112121212112221212112121212121211221222222211211121211212121212112121212112221212112121212121211221222222211211121211212121212112121212112221212112121212121211221
11111111111111111111111111111111111111111111111111111111111111111111111111111111111111111111111111111111111111111111111111111111111111111111111111111111111111111111111111111111111111111111111111111111111111111111111111111111
22222222222222222222222222222222222222222222222222222222222222222222222222222222222222222222222222222222222222222222222222222222222222222222222222222222222222222222222222222222222222222222222222222222222222222222222222222222
11112212121212122222112121221221111122121212121222221121212212211111221212121212222211212122122111112212121212122222112121221221111122121212121222221121212212211111221212121212222211212122122111112212121212122222112121221221
11112212121212122222112121221221111122121212121222221121212212211111221212121212222211212122122111112212121212122222112121221221111122121212121222221121212212211111221212121212222211212122122122222221121112121121212121211221
12121212112221212112121212121211221222222211211121211212121212112121212112221212112121212121211221222222211211121211212121212112121212112221212112121212121211221222222211211121211212121212112121212112221212112121212121211221
11111111111111111111111111111111111111111111111111111111111111111111111111111111111111111111111111111111111111111111111111111111111111111111111111111111111111111111111111111111111111111111111111111111111111111111111111111111
22222222222222222222222222222222222222222222222222222222222222222222222222222222222222222222222222222222222222222222222222222222222222222222222222222222222222222222222222222222222222222222222222222222222222222222222222222222
11112212121212122222112121221221111122121212121222221121212212211111221212121212222211212122122111112212121212122222112121221221111122121212121222221121212212211111221212121212222211212122122111112212121212122222112121221221
