GGGGGGGGGGGGGGGGGGGGGGGGG
GGGGGGGGGGGGGGGGGGGGGGGGG
GGGGGGGGGGGGGGGGGGGGGGGGG
GGGFFGWGWGGGWGGGWGGGGGGGG
GGGFGGWGWGGGGGGGGGGGGGGGG
GGGFFGWGWGGGGGFGGGGGGGGGG
GGGFGGWGWGGGFGGGFGGGGGGGG
GGGFFGWWWGGGFFFFFGGGGGGGG
GGGGGGGGGGGGGGGGGGGGGGGGG
GGGGGGGGGGGGGGGGGGGGGGGGG
GGGGGGGGGGGGGGGGGGGGGGGGG