GGGGGGGGGGGGGGGGGGGG
GGGGGGGGGGGGGGGGGGGG
GGFFFFGGGGGGGGGGGGGG
GGFFGGGGGGGGGGGGGGGG
GGFFGGGGGGGGGGGGGGGG
GGFFFGGGGGGGGGGGGGGG
GGGGGGGGGGGGGGGGGGGG
GGGGGWWWWWWGGGGGGGGG
GGGGGGGGGGGGGGGGGGGG
GGGGGGGGGGGGGGGGGGGG