GGGGGGGGGGGGGGGGGGGGGGGGG
GGGGGGGGGGGGGGGGGGGGGGGGG
GGGGGGGGGGGGGGGGGGGGGGGGG
GGGFFGWGWGGGGGGGGGGGGGGGG
GGGFGGWGWGGGGGGGGGGGGGGGG
GGGFFGWGWGGGGGGGGGGGGGGGG
GGGFGGWGWGGGGGGGGGGGGGGGG
GGGFFGWWWGGGGGGGGGGGGGGGG
GGGGGGGGGGGGGGGGGGGGGGGGG
GGGGGGGGGGGGGGGGGGGGGGGGG
GGGGGGGGGGGGGGGGGGGGGGGGG