GGGGGGGGGGGGGGGGGGGG
GGGGGGGGGGGGGGGGGGGG
GGFFFFGGGGGGGGGGGGGG
GGFFGGGGGGGGGGGGGGGG
GGFFGGGGGGGGGGGGGGGG
GGFFFGGGGGGGWGGGGGGG
GGGGGGGGGWWWWGGGGGGG
GGGGGWWWWWWGGGGGGGGG
GGGGGGGWWWWWGGGGGGGG
GGGGGGGGGGGGGGGGGGGG